0    0    0    0    0    0    0    0
22   19   16   13   10   8    5    2
59   51   44   36   29   22   14   7
160  140  120  100  80   60   40   20
436  382  327  272  218  163  109  54
1187 1038 890  742  593  445  296  148
3227 2824 2420 2017 1613 1210 806  403